[console_scripts]
sphinxreport-test = SphinxReport.test:main
sphinxreport-build = SphinxReport.build:main
sphinxreport-clean = SphinxReport.clean:main
sphinxreport-get = SphinxReport.get:main
sphinxreport-profile = SphinxReport.profile:main
sphinxreport-serve = SphinxReport.serve:main
sphinxreport-quickstart = SphinxReport.quickstart:main

[SphinxReport.plugins]
render-pie-plot = SphinxReportPlugins.Plotter:PiePlot
render-r-smooth-scatter-plot = SphinxReportPlugins.RPlotter:SmoothScatterPlot
transform-stats = SphinxReportPlugins.Transformer:TransformerStats
transform-test-mwu = SphinxReportPlugins.Transformer:TransformerMannWhitneyU
transform-tolist = SphinxReportPlugins.Transformer:TransformerToList
render-bar-plot = SphinxReportPlugins.Plotter:BarPlot
transform-contingency = SphinxReportPlugins.Transformer:TransformerContingency
render-venn-plot = SphinxReportPlugins.Plotter:VennPlot
render-debug = SphinxReportPlugins.Renderer:Debug
transform-select = SphinxReportPlugins.Transformer:TransformerSelect
render-stacked-bar-plot = SphinxReportPlugins.Plotter:StackedBarPlot
transform-indicator = SphinxReportPlugins.Transformer:TransformerIndicator
rplot = SphinxReportPlugins.RPlotPlugin:RPlotPlugin
render-box-plot = SphinxReportPlugins.Plotter:BoxPlot
transform-histogram = SphinxReportPlugins.Transformer:TransformerHistogram
html = SphinxReportPlugins.HTMLPlugin:HTMLPlugin
render-scatter-plot = SphinxReportPlugins.Plotter:ScatterPlot
render-glossary = SphinxReportPlugins.Renderer:Glossary
transform-correlation = SphinxReportPlugins.Transformer:TransformerCorrelationPearson
render-matrix-plot = SphinxReportPlugins.Plotter:TableMatrixPlot
transform-combine = SphinxReportPlugins.Transformer:TransformerCombinations
render-histogram-plot = SphinxReportPlugins.Plotter:HistogramPlot
transform-group = SphinxReportPlugins.Transformer:TransformerGroup
render-rsttable = SphinxReportPlugins.Renderer:RstTable
transform-pearson = SphinxReportPlugins.Transformer:TransformerCorrelationPearson
transform-combinations = SphinxReportPlugins.Transformer:TransformerCombinations
render-hinton-plot = SphinxReportPlugins.Plotter:HintonPlot
render-line-plot = SphinxReportPlugins.Plotter:LinePlot
matplotlib = SphinxReportPlugins.MatplotlibPlugin:MatplotlibPlugin
transform-filter = SphinxReportPlugins.Transformer:TransformerFilter
render-histogram-gradient-plot = SphinxReportPlugins.Plotter:HistogramGradientPlot
render-matrixNP = SphinxReportPlugins.Renderer:NumpyMatrix
transform-toframe = SphinxReportPlugins.Transformer:TransformerToDataFrame
transform-tolabels = SphinxReportPlugins.Transformer:TransformerToLabels
render-r-heatmap-plot = SphinxReportPlugins.RPlotter:HeatmapPlot
rst = SphinxReportPlugins.RSTPlugin:RSTPlugin
transform-aggregate = SphinxReportPlugins.Transformer:TransformerAggregate
render-matrix = SphinxReportPlugins.Renderer:TableMatrix
render-r-line-plot = SphinxReportPlugins.RPlotter:LinePlot
render-status = SphinxReportPlugins.Renderer:Status
render-user = SphinxReportPlugins.Renderer:User
render-matrixNP-plot = SphinxReportPlugins.Plotter:NumpyMatrixPlot
render-scatter-rainbow-plot = SphinxReportPlugins.Plotter:ScatterPlotWithColor
render-interleaved-bar-plot = SphinxReportPlugins.Plotter:InterleavedBarPlot
render-r-box-plot = SphinxReportPlugins.RPlotter:BoxPlot
transform-spearman = SphinxReportPlugins.Transformer:TransformerCorrelationSpearman
render-gallery-plot = SphinxReportPlugins.Plotter:GalleryPlot
xls = SphinxReportPlugins.XLSPlugin:XLSPlugin
render-r-ggplot = SphinxReportPlugins.RPlotter:GGPlot
render-table = SphinxReportPlugins.Renderer:Table

[distutils.commands]
build_sphinx = sphinxreport.setup_command:BuildDoc

