[paste.filter_factory]
bark = bark.middleware:bark_filter

[bark.conversion]
A = bark.conversions:LocalAddressConversion
C = bark.conversions:CookieConversion
B = bark.conversions:ResponseSizeConversion
D = bark.conversions:ServeTimeConversion
H = bark.conversions:ProtocolConversion
L = bark.conversions:UnavailableConversion
P = bark.conversions:ProcessIDConversion
R = bark.conversions:UnavailableConversion
U = bark.conversions:URLConversion
T = bark.conversions:ServeTimeConversion
V = bark.conversions:ServerNameConversion
X = bark.conversions:UnavailableConversion
a = bark.conversions:AddressConversion
b = bark.conversions:ResponseSizeConversion
e = bark.conversions:EnvironmentConversion
f = bark.conversions:FilenameConversion
i = bark.conversions:RequestHeaderConversion
h = bark.conversions:HostnameConversion
k = bark.conversions:KeepAliveConversion
m = bark.conversions:RequestMethodConversion
l = bark.conversions:UnavailableConversion
o = bark.conversions:ResponseHeaderConversion
n = bark.conversions:NoteConversion
q = bark.conversions:QueryStringConversion
p = bark.conversions:PortConversion
s = bark.conversions:StatusConversion
r = bark.conversions:FirstLineConversion
u = bark.conversions:RemoteUserConversion
t = bark.conversions:TimeConversion
w = bark.conversions:WSGIEnvironmentConversion
v = bark.conversions:ServerNameConversion

[bark.handler]
http = bark.handlers:http_handler
stderr = bark.handlers:stderr_handler
watched_file = bark.handlers:watched_file_handler
syslog = bark.handlers:syslog_handler
smtp = bark.handlers:smtp_handler
timed_rotating_file = bark.handlers:timed_rotating_file_handler
stdout = bark.handlers:stdout_handler
rotating_file = bark.handlers:rotating_file_handler
datagram = bark.handlers:datagram_handler
file = bark.handlers:file_handler
nt_event_log = bark.handlers:nt_event_log_handler
null = bark.handlers:null_handler
socket = bark.handlers:socket_handler

